%%%%%%%%%%%%%%%%%%%%%%%%%%%%%%%%%%%%%
%     ................%.............%
%     ................%.............%
%     ................%.............%
%     ................%.............%
%     ................%.............%
%     ................%%%%%%........%
%     .....................%........%
%     .....................%........%
%     .....................%........%
%     .....................%........%
%     .....................%........%
%     ...%%%%%%%%%%%%...............%
%     ...%           ...............%
%     ...%           ...............%
%     ...%           ...............%
%     ...%           ...............%
%     ...%           ...............%
%     ..O%           ...............%
%%%%%%%%%%%%%%%%%%%%%%%%%%%%%%%%%%%%%
